111111111111111111111111111111111111111111111111111111111111
100000000000000000000000000000000000000000000000000000000001
10C0000000000000000000000000000000000000000000000000000000C1
10C0000000000000000000000000000000000000000000000000000000C1
10C0000000000000000000000000000000000000000000000000000000C1
10C0000000000000000000000000000000000000000000000000000000C1
10C00000000000000000000000000000000000000000000000000P0000C1
10C0000000000000000000000000000000000000000000000000000000C1
10C0000000000000000000000000000000000000000000000000000000C1
10C0000000000000000000000000000000000000000000000000000000C1
10C0000000000000000000000000000000000000000000000000000000C1
10C0000000000000000000000000000000000000000000000000000000C1
10C0000000000000000000000000000000000000000000000000000000C1
10C0000000000000000000000000000000000000000000000000000000C1
10C0000000000000000000000000000000000000000000000000000000C1
10C0000000000000000000000000000000000000000000000000000000C1
10C0000000000000000000000000000000000000000000000000000000C1
10C0000000000000000000000000000000000000000000000000000000C1
10C0000000000000000000000000000000000000000000000000000000C1
10C0000000000000000000000000000000000000000000000000000000C1
10C0000000000000000000000000000000000000000000000000000000C1
10C0000000000000000000000000000000000000000000000000000000C1
10C0000000000000000000000000000000000000000000000000000000C1
10C0000000000000000000000000000000000000000000000000000000C1
10C0000000000000000000000000000000000000000000000000000000C1
10C0000000000000000000000000000000000000000000000000000000C1
10C0000000000000000000000000000000000000000000000000000000C1
10C0000000000000000000000000000000000000000000000000000000C1
10C0000000000000000000000000000000000000000000000000000000C1
10C0000000000000000000000000000000000000000000000000000000C1
10C0000000000000000000000000000000000000000000000000000000C1
1E0000000000000000000000000000000000000000000000000000000001
111111111111111111111111111111111111111111111111111111111111