11111111111111111111111111
10000000000000000000000001
10C000000000000000000000C1
10C0000000000000000P0000C1
10C000000000000000000000C1
10C000000000000000000000C1
10C000000000000000000000C1
1E000000000000000000000001
11111111111111111111111111